Абзал
Абыз
Агзам
Азамат
Азат
Айдар
Акылбай
Алдияр
Алтынбек
Амир
Аркат
Арнур
Асан
Аслан
Асмет
Атабай
Атабек
Ахат
Ахмет
Байсал
Бакир
Бактияр
Баттал
Бахыт
Баязит
Бекзат
Берик
Габит
Гани
Дамир
Данияр
Дияр
Едиге
Ерасыл
Ескали
Жагыпар
Жамбыл
Жамшид
Жанабил
Жаназар
Жанболат
Жангали
Жангир
Жандос
Жарас
Зайыр
Закия
Заки
Илияс
Имран
Ислам
Кадыр
Кайрат
Кайсар
Кайым
Кайыргали
Карим
Касиман
Касымхан
Кобжан
Мади
Мажит
Малик
Манар
Мансур
Махамбет
Музаффар
Мукагали
Мурат
Мустафа
Муталип
Мухаммад
Мухтар
Наби
Накып
Нурлыбек
Омар
Райымбек
Рашит
Рустем
Рустэм
Сабаз
Сабит
Сагит
Самат
Саурык
Сахи
Сейфолла
Серке
Сулеймен
Сырым
Таймас
Талмас
Тамерлан
Таргын
Темирхан
Тигран
Уайыс
Уали
Умбет
Хамит
Хафиз
Шерхан
Шора
Абиг - воспевающий
Авет, Аветик, Аветис - благосвет, священное знание 
Агаси - непоколебимый
Азат - свободный Айк,
Айказ - единство
Акоп - бог да поможет, да охранит 
Амазасп - победоносно идущий защитник 
Амаяк - искренний, высший дух 
Амбарцум - вознесение, светящийся, сверкающий в небе 
Амо - идущий Анания - единственный в своем роде 
Ара - благородный Аракел - апосол, божественный защитник 
Арам - благородный 
Аргам - достойный 
Аргишти - достойный любви 
Арег - солнце, священное движение (знак) 
Аристакес - святой защитник 
Армен, Арменак - дух ариев 
Арсен - благородный воин 
Артавазд - обитель истины 
Артак - стремящийся к солнцу Арташ, 
Арташес - стремящийся к истине 
Артем - путь к истине 
Артур - свет истины 
Артуш - стремящийся к свету 
Арутюн - воскресение 
Арушан - солнечный лик 
Аршавир - солнечный герой 
Аршак - животворящее солнце 
Атом - божественный дух 
Ашот - надежда этого мира 
Бабкен - отец-мудрец 
Багдасар - благодатная сила 
Багиш - упоение счастьем 
Баграм - счастье любви 
Баграт - радость любви 
Барсег - очень влиятельный 
Бархудар - почитающий силы 
Ваагн - вездесущий огонь 
Ваан - щит, вездесущий 
Вагарш, Вагаршак - вездесущее солнце 
Ваграм - стремительность тигра 
Вазген - свет священного знания 
Ваник - купец 
Вараздат - дар пространства 
Вардан - награда 
Вардван - патриот, любящий страну 
Вардгес - царь (лев) страны 
Варужан - рожденный быть защитником 
Васак - свет очей 
Вахак - вездесущее солнце 
Вахинак - солнечный воин 
Вачаган - огненная речь 
Ваче - речь, слово 
Виген - сильный, могущественный 
Вираб - герой-защитник Врамшапух - благая клятва 
Гагик - небесный 
Галуст - приход, приход в дом 
Герегин - огонь священного знания 
Гарник - ягненок, жертвенный агнец, ведомый к огню 
Гарсеван - огнепоклонник
Гаспар - идущий освобождать 
Гегам - дом 
Грант - священная книга 
Гурген - священное знание от духовного учителя 
Давид - дающий знание 
Дереник - смиренно поклоняющийся богу 
Дживан - живая воплощенная душа 
Егиш - жаждущий могущества 
Ерванд - святая вера, святое почитание 
Жирайр - бойкий, живой арий (мужчина) 
Завен - благовоспитанный, смиренный 
Зорий - жрец культа солнца и огня 
Зураб - божественный, благоухающий
Камари - святая любовь 
Карапет - владыка лучей солнца, солнце 
Карен - слон 
Кероп - солнечная стрела 
Кикос - твердый, стойкий 
Киракос - летописец 
Корюн - воспевающий, восхваляющий бога, солнце 
Мамикон - мой 
Маркар - путь ариев, благородный путь 
Мгер - солнечный 
Мелкон - встречающий солнце 
Мелкум - встречающий рассвет 
Месроп - лунная стрела 
Мехак - гвоздика, солнечный глаз 
Мигран - солнечный лик 
Минас - рыба 
Мушег - превосходный 
Нерсес - рождение героя 
Нубар - восхваление 
Оган, Оганес, Ованес - огненный
Панос - удивительный, чудесный 
Паркев - награда, обычай возлияний (связано с жертвоприношением) 
Партев - властелин, царь, воин 
Паруйр - спираль, наполненный светом 
Парунак - частица бога 
Патвакан - достоинство, честь смолоду 
Петрос - камень, отчий, отцовский 
Погос - мальчик 
Рачия - созидание, творение
Саак - могущество солнца 
Сагател - знак могущества 
Сако - божественный 
Санасар - сила вечности 
Сантур - священный свет 
Сапах - почитающий бога 
Саргис - могущество природы 
Саро - сильный
Татевос - путь предков 
Татос - отцовский 
Татул - радость отца 
Тиран - священное лицо 
Торгом - идущий спаситель 
Торос - напор, Энергия 
Трдат - дар богов 
Унан - золотой лик, солнце 
Усик - утренний 
Харпут - солнечный лотос 
Хорен - солнце
Хосров - бросающий жертву в поток огня (связано с жертвоприношением)
Шаварш - могущество солнца Шмавон - миролюбивый
Або - в честь святого мученика Або Тбилели, принявшего христианство
Авто - сердце родины
Антон - воин, предводитель
Автандил - сердце родины
Амиран - правитель, высокий
Арчил - правильный, открытый, благославенный
Алика - защитник
Алико - защитник
Алекс - защитник

Бадри - полная луна, идеальное создание
Барам - изгнавший демона Веретре
Бесо - сын любимой жены, сын десницы
Бесарион - лесистое ущелье
Бердиа - дарованный Богом, подарок Господа
Бердо - дарованный Богом, подарок Господа
Битчия - юноша, мальчик
Биджо - юный
Бичико - мальчик

Вано - милость Божья
Васо - царский
Вахтанг - волчье тело, волк
Важа - мужественный, рыцарь
Вепхо - тигр

Генацвале - друг
Геронти - старый человек, старейший
Гия - земледелец
Гоги - храбрый
Гиорги - земледелец
Гогита - земледелец
Гоча - старец, маленький
Гурам - изгнавший демона Веретре

Давид - любимый
Дато - возлюбленный
Даниэл - судья Божий
Джано - влюбленный, с пылающим сердцем
Джансуг - влюбленный, с пылающим сердцем
Джанико - влюбленный, с пылающим сердцем
Джумбер - молодой лев
Дурсун - остающийся

Заза - старец, старик
Звиад - спесивый, высокомерный
Зураб - красный драгоценный камень

Иаго - идущий за кем-то
Илиа - крепость Господня
Илья - крепость Господня
Иракли - герой, слава Геры
Ираклий - герой, слава Геры
Иванэ - милость Божья

Каха - из Кахетии, победитель
Коба - последователь

Ладо - владеющий миром
Лаша - светлый, свет
Леван - лев
Ломи - лев
Лев - лев
Леон - лев
Левтер - свободный
Лука - свет
Лукиан - свет
Лукиа - свет

Малхаз - князь
Мамука - восход солнца
Мгелико - волчонок

Николай - побеждающий народ
Николоз - победивший народ
Никандро - победитель мужей
Нугзар - очень молодой

Отар - ароматный, лекарство
Отиа - ароматный, лекарство

Павле - маленький, мелкий
Павлиа - маленький, мелкий
Павлико - маленький, мелкий
Петрэ - камень, скала
Патриа - камень, скала
Петиа - камень, скала
Пета - камень, скала
Пето - камень, скала
Петруа - камень, скала
Петуа - камень, скала

Реваз - великий, выдающийся
Резо - великий, выдающийся
Резико - великий, выдающийся
Ростом - богатырь
Рожден - мученик
Рустам - богатырь, могучий

Саба - старик, лишенный свободы
Серги - высокий, высокочтимый
Серго - высокий, высокочтимый
Сергиа - высокий, высокочтимый
Сосо - прибавление, увеличение
Сула - душа
Сулико - душенька

Тамта - Богу посвященный, сильный, мужественный
Тамази - близнец
Тамаз - сильный наездник
Тариэл - царь-герой
Тенгиз - великий, сильный
Темур - железо
Тимур - железо
Тит - честь, почет
Титиа - честь, почет
Титико - честь, почет
Тито - честь, почет
Торнике - победитель

Хвича - блестящий, мерцающий
Чичико - человечек

Шалва - мир
Шавела - мир
Шалико - мир
Шалика - мир
Шалута - мир
Шота - огонь
Шукри - земледелец

Яго - идущий за кем-то